
SO textures/wall_2.xpm

NO textures/wall_2.xpm

WE textures/wall_2.xpm




F 165,42,42
EA textures/wall_2.xpm






C 135,206,235









111111111111
100000000111
100000011111
10N000001111
100000000001
111111111111