NO ./textures/north_texture.xpm
SO ./textures/south_texture.xpm
WE ./textures/west_texture.xpm
EA ./textures/east_texture.xpm

F 220,100,0
C 255,0,255

11111111111111111111111
100000000000S00000000001
11000000000000000000001
1110000000000000000001
111100000000000000001
11111000000000000001
1111110000000000001
111111100000000001
11111111000000001
1111111110000001
111111111100001
11111111111001
1111111111111