NO ./textures/north_texture.xpm
SO ./textures/south_texture.xpm
WE ./textures/west_texture.xpm
EA ./textures/east_texture.xpm

F 220,30,0
C 225,30,0

11111111
100000011111
1E0000000001
100000011111
11111111
