NO
SO
WE
EA

F 220, 100, 0
C 225, 30, 0

111111111111111111111111111
100000000000000010000000001
100000000000000010000000001
100000000000000000000000001
100000000000000000000000001
100000000000000000000000001
100000000000000000000000001
100010000000000000000000001
1000100000000000000000000N1
111111111111111111111111111