NO
SO
WE
EA

F 220, 30, 0
C 225, 30, 0

111111111111111111111111111
100000000000000010000000001
100000000000000010000000001
100000000000000000000000001
100000000000000000000000001
100000000000000000000000001
100000000000000000000000001
100010000000000000000000001
10001000000000000Z000000001
111111111111111111111111111