NO ./textures/north_texture.xpm
SO ./textures/south_texture.xpm
WE ./textures/west_texture.xpm
EA ./textures/east_texture.xpm

F 0, 93, 51
C 4, 6, 47

111111111111111111111111111
100000000001100000000000001
100000000000000000000000001
10000111D110001100000000001
100000000000000000000000001
100000000000000010000000001
100000000000000000000000001
100010000111000001000000001
10001000000000E000000000001
111111111111111111111111111