NO ./textures/north_texture.xpm
SO ./textures/south_texture.xpm
WE ./textures/west_texture.xpm
EA ./textures/east_texture.xpm

F 220,30,0
C 225,30,0

111111111111111111111111111
100000000001100000000000001
100000000000000000000000001
100001111110001100000000001
100000000000000000000000001
100000000000000010000000001
100000000000000000000000001
100010000111000001000000001
10001000000000E000000000001
111111111111111111111111111