
NO ./textures/north_texture.xpm
SO ./textures/south_texture.xpm
WE ./textures/west_texture.xpm
EA ./textures/east_texture.xpm

F 220   ,   100,   0
C 255,0,255

111111111111111111111111111
100000000001100000000000001
100000000000000000000000001
100001111110001100000000001
1000000000000000E0000000001
100000000000000010000000001
100000000000000000000000001
1000100001111D1111000000001
100010000000000000000000001
111111111111111111111111111